//MAP CONVERTED BY dmm2tgm.py THIS HEADER COMMENT PREVENTS RECONVERSION, DO NOT REMOVE
"a" = (
/turf/open/space/basic,
/area/space)
"b" = (
/turf/open/floor/engine/airless,
/area/hallway/primary/upper)
"c" = (
/obj/machinery/light/floor,
/turf/open/floor/engine/airless,
/area/hallway/primary/upper)
"d" = (
/turf/closed/wall/r_wall,
/area/hallway/primary/upper)
"e" = (
/obj/effect/spawner/structure/window/plasma,
/turf/open/floor/plating,
/area/hallway/primary/upper)
"f" = (
/turf/open/floor/iron,
/area/hallway/primary/upper)
"g" = (
/turf/open/openspace,
/area/hallway/primary/upper)
"h" = (
/obj/machinery/light/floor,
/turf/open/floor/iron,
/area/hallway/primary/upper)
"i" = (
/turf/open/floor/plating,
/area/hallway/primary/upper)
"j" = (
/obj/structure/lattice/catwalk,
/turf/open/openspace,
/area/hallway/primary/upper)
"k" = (
/obj/machinery/light/floor,
/obj/structure/railing{
	dir = 1
	},
/turf/open/floor/iron,
/area/hallway/primary/upper)
"l" = (
/obj/structure/railing{
	dir = 1
	},
/turf/open/floor/iron,
/area/hallway/primary/upper)
"m" = (
/obj/machinery/door/airlock/public/glass{
	name = "Main Floor"
	},
/turf/open/floor/iron,
/area/hallway/primary/upper)
"n" = (
/obj/machinery/light/floor,
/obj/structure/cable,
/obj/machinery/power/apc/auto_name/directional/west,
/turf/open/floor/iron,
/area/hallway/primary/upper)
"o" = (
/obj/structure/cable/multilayer/multiz,
/turf/open/floor/plating,
/area/hallway/primary/upper)
"p" = (
/obj/structure/ladder,
/turf/open/floor/iron,
/area/hallway/primary/upper)
"q" = (
/obj/machinery/door/airlock/public/glass{
	name = "Basic Equipment Tests"
	},
/turf/open/floor/iron,
/area/hallway/primary/upper)
"r" = (
/obj/machinery/light/floor,
/turf/open/floor/plating,
/area/hallway/primary/upper)
"s" = (
/obj/machinery/door/airlock/public/glass,
/turf/open/floor/iron,
/area/hallway/primary/upper)
"t" = (
/obj/machinery/light/floor,
/obj/machinery/atmospherics/components/unary/passive_vent,
/turf/open/floor/iron,
/area/hallway/primary/upper)
"u" = (
/obj/machinery/door/airlock/external/glass,
/turf/open/floor/plating,
/area/hallway/primary/upper)
"v" = (
/obj/machinery/meter/turf,
/turf/open/floor/iron,
/area/hallway/primary/upper)
"w" = (
/obj/machinery/atmospherics/pipe/smart/simple/general/visible,
/turf/open/floor/iron,
/area/hallway/primary/upper)
"x" = (
/obj/machinery/door/airlock/public/glass,
/obj/machinery/atmospherics/pipe/smart/simple/general/visible,
/turf/open/floor/iron,
/area/hallway/primary/upper)
"y" = (
/obj/machinery/light/floor,
/obj/machinery/atmospherics/components/unary/passive_vent{
	dir = 1;
	icon_state = "passive_vent_map-3"
	},
/turf/open/floor/iron,
/area/hallway/primary/upper)
"z" = (
/obj/machinery/light/floor,
/turf/open/floor/iron/red,
/area/hallway/primary/upper)
"A" = (
/turf/open/floor/iron/red,
/area/hallway/primary/upper)
"B" = (
/obj/machinery/meter/turf,
/turf/open/floor/iron/red,
/area/hallway/primary/upper)

(1,1,1) = {"
a
a
a
a
a
a
a
a
a
a
a
a
a
a
a
a
a
a
a
a
a
a
a
a
a
a
a
a
a
a
a
a
a
a
a
a
a
a
a
a
a
"}
(2,1,1) = {"
a
b
b
b
b
b
b
d
d
e
e
e
e
e
e
e
e
e
e
e
d
d
d
e
e
e
e
e
e
e
e
d
d
d
d
e
e
e
d
d
a
"}
(3,1,1) = {"
a
b
b
b
b
b
b
d
g
g
g
g
g
g
g
g
g
k
f
f
n
d
i
i
i
f
f
f
f
f
f
f
f
d
f
f
f
f
f
d
a
"}
(4,1,1) = {"
a
b
b
b
b
b
b
e
g
g
g
g
g
g
g
g
g
l
f
f
o
e
i
i
i
f
f
f
f
f
f
f
f
e
f
f
h
f
f
e
a
"}
(5,1,1) = {"
a
b
b
c
b
b
b
e
g
g
g
g
g
g
g
g
g
l
f
f
f
e
i
i
i
f
f
f
f
f
f
f
f
s
f
f
v
f
f
e
a
"}
(6,1,1) = {"
a
b
b
b
b
b
b
e
g
g
g
g
g
g
g
g
g
l
f
f
h
e
i
r
i
f
f
f
h
f
f
h
f
e
f
f
f
f
f
e
a
"}
(7,1,1) = {"
a
b
b
b
b
b
b
d
g
g
g
g
g
g
g
g
g
k
f
f
p
d
i
i
i
f
f
f
f
f
f
f
f
d
f
f
f
f
f
d
a
"}
(8,1,1) = {"
a
b
b
b
b
b
b
d
d
i
i
i
i
i
i
i
d
d
d
m
d
d
i
i
i
f
f
f
f
f
f
f
f
d
d
e
s
e
d
d
a
"}
(9,1,1) = {"
a
b
b
c
b
b
b
d
f
f
f
f
f
f
f
f
f
d
f
f
f
d
i
i
i
f
f
f
f
f
f
f
f
d
f
f
f
f
f
d
a
"}
(10,1,1) = {"
a
b
b
b
b
b
b
e
f
g
g
g
j
g
g
g
f
f
f
f
f
e
i
i
i
f
f
f
f
f
f
f
f
e
f
f
f
f
f
e
a
"}
(11,1,1) = {"
a
b
b
b
b
b
b
e
f
g
g
g
j
g
g
g
f
f
f
f
f
e
i
r
i
f
f
i
h
f
f
h
f
e
f
f
f
f
f
e
a
"}
(12,1,1) = {"
a
b
b
b
b
b
b
e
f
g
g
f
f
f
g
g
f
h
f
f
f
e
i
i
i
f
i
i
i
f
f
f
f
s
f
f
v
f
f
e
a
"}
(13,1,1) = {"
a
b
b
b
b
b
b
d
h
j
j
f
h
f
j
j
f
f
f
f
f
e
i
i
i
f
i
i
i
f
f
f
f
e
f
f
h
f
f
e
a
"}
(14,1,1) = {"
a
b
b
b
b
b
b
d
f
g
g
f
f
f
g
g
f
f
h
f
f
d
i
i
i
f
i
i
i
f
f
f
f
e
f
f
f
f
f
e
a
"}
(15,1,1) = {"
a
b
b
c
b
b
b
d
f
g
g
g
j
g
g
g
f
f
f
f
f
q
f
f
f
f
f
i
f
f
f
f
f
d
f
f
f
f
f
d
a
"}
(16,1,1) = {"
a
b
b
b
b
b
b
e
f
g
g
g
j
g
g
g
f
i
f
f
f
q
f
h
f
f
f
f
h
f
f
h
f
d
d
e
s
e
d
d
a
"}
(17,1,1) = {"
a
b
b
b
b
b
b
e
f
g
g
f
f
f
g
g
f
i
f
f
f
q
f
f
f
f
f
f
f
f
f
f
f
d
f
f
f
f
f
d
a
"}
(18,1,1) = {"
a
b
b
b
b
b
b
e
h
j
j
f
h
f
j
j
f
i
f
f
f
d
f
f
f
f
f
f
f
f
f
f
f
e
f
f
f
f
f
e
a
"}
(19,1,1) = {"
a
b
b
b
b
b
b
d
f
g
g
f
f
f
g
g
f
f
f
h
f
e
f
f
f
f
f
f
f
f
f
f
f
s
f
f
h
f
f
e
a
"}
(20,1,1) = {"
a
b
b
b
b
b
b
d
f
g
g
g
j
g
g
g
f
f
f
f
f
e
f
f
f
f
f
f
f
f
f
f
f
e
f
f
v
f
f
e
a
"}
(21,1,1) = {"
a
b
b
c
b
b
b
d
f
g
g
g
j
g
g
g
f
f
f
f
f
e
f
h
f
f
f
f
h
f
f
h
f
e
f
f
f
f
f
e
a
"}
(22,1,1) = {"
a
b
b
b
b
b
b
e
f
g
g
f
f
f
g
g
f
f
f
f
f
e
f
f
f
f
f
f
f
i
f
f
f
d
f
f
f
f
f
d
a
"}
(23,1,1) = {"
a
b
b
b
b
b
b
e
h
j
j
f
h
f
j
j
f
h
f
f
f
e
f
f
f
f
i
i
f
i
f
f
f
d
d
e
s
e
d
d
a
"}
(24,1,1) = {"
a
b
b
b
b
b
b
e
f
g
g
f
f
f
g
g
f
f
f
f
f
e
f
f
f
f
i
i
f
i
f
f
f
d
z
A
A
z
B
d
a
"}
(25,1,1) = {"
a
b
b
c
b
b
b
d
f
g
g
g
j
g
g
g
f
f
f
h
f
e
f
f
f
f
f
f
f
i
f
f
f
e
A
g
g
g
z
e
a
"}
(26,1,1) = {"
a
b
b
b
b
b
b
d
f
g
g
g
j
g
g
g
f
f
f
f
f
e
f
h
f
f
f
f
h
f
f
h
f
s
A
g
g
g
A
u
a
"}
(27,1,1) = {"
a
b
b
b
b
b
b
d
f
g
g
f
f
f
g
g
f
f
f
f
f
e
f
f
f
f
f
f
f
f
f
f
f
e
A
g
g
g
A
e
a
"}
(28,1,1) = {"
a
b
b
b
b
b
b
e
h
j
j
f
h
f
j
j
f
f
f
f
f
e
f
f
f
f
f
f
f
f
f
f
f
d
z
A
A
A
z
d
a
"}
(29,1,1) = {"
a
b
b
b
b
b
b
e
f
g
g
f
f
f
g
g
f
f
f
f
f
d
e
s
e
d
e
s
e
d
e
s
e
d
d
e
u
e
d
d
a
"}
(30,1,1) = {"
a
b
b
c
b
b
b
e
f
g
g
g
j
g
g
g
f
f
f
h
f
e
f
f
v
e
f
f
v
e
f
f
f
e
a
a
a
a
a
a
a
"}
(31,1,1) = {"
a
b
b
b
b
b
b
d
f
g
g
g
j
g
g
g
f
f
f
f
f
e
f
t
w
x
w
y
f
s
f
h
f
e
a
a
a
a
a
a
a
"}
(32,1,1) = {"
a
b
b
b
b
b
d
d
f
f
f
f
f
f
f
f
f
f
f
f
f
e
f
f
f
e
f
f
f
e
f
f
f
e
a
a
a
a
a
a
a
"}
(33,1,1) = {"
a
a
a
a
a
a
d
f
f
f
f
f
f
f
f
f
f
h
f
f
f
d
e
s
e
d
e
s
e
d
f
v
f
d
a
a
a
a
a
a
a
"}
(34,1,1) = {"
a
a
a
a
a
a
e
f
h
f
f
f
f
f
f
f
f
f
f
f
f
e
g
f
v
e
f
f
v
e
f
f
f
e
a
a
a
a
a
a
a
"}
(35,1,1) = {"
a
a
a
a
a
a
e
f
f
f
f
h
f
f
f
f
f
f
f
f
f
e
g
h
f
s
f
h
f
s
f
h
f
e
a
a
a
a
a
a
a
"}
(36,1,1) = {"
a
a
a
a
a
a
e
f
f
f
f
f
f
f
f
h
f
f
f
f
f
e
g
f
f
e
f
f
f
e
f
f
f
e
a
a
a
a
a
a
a
"}
(37,1,1) = {"
a
a
a
a
a
a
e
f
f
f
f
f
f
f
f
f
f
f
f
f
f
d
e
u
e
d
e
u
e
d
e
u
e
d
a
a
a
a
a
a
a
"}
(38,1,1) = {"
a
a
a
a
a
a
d
f
f
f
f
f
f
f
f
f
f
f
f
f
f
d
a
a
a
a
a
a
a
a
a
a
a
a
a
a
a
a
a
a
a
"}
(39,1,1) = {"
a
a
a
a
a
a
d
d
e
e
e
d
e
e
e
e
d
e
e
e
d
d
a
a
a
a
a
a
a
a
a
a
a
a
a
a
a
a
a
a
a
"}
(40,1,1) = {"
a
a
a
a
a
a
a
a
a
a
a
a
a
a
a
a
a
a
a
a
a
a
a
a
a
a
a
a
a
a
a
a
a
a
a
a
a
a
a
a
a
"}
