//MAP CONVERTED BY dmm2tgm.py THIS HEADER COMMENT PREVENTS RECONVERSION, DO NOT REMOVE
"aa" = (
/turf/open/space/basic,
/area/space)
"ab" = (
/turf/closed/wall/r_wall,
/area/station/hallway/primary/central)
"ac" = (
/obj/effect/spawner/structure/window/plasma,
/turf/open/floor/plating,
/area/station/hallway/primary/central)
"ad" = (
/obj/machinery/door/poddoor{
	id = "c1vent";
	name = "c1vent"
	},
/turf/open/floor/plating,
/area/station/hallway/primary/central)
"ae" = (
/obj/machinery/door/poddoor{
	id = "c2vent";
	name = "c2vent"
	},
/turf/open/floor/plating,
/area/station/hallway/primary/central)
"af" = (
/obj/machinery/door/poddoor{
	id = "c3vent";
	name = "c3vent"
	},
/turf/open/floor/plating,
/area/station/hallway/primary/central)
"ag" = (
/turf/open/floor/iron,
/area/station/hallway/primary/central)
"ah" = (
/turf/open/floor/engine/plasma,
/area/station/hallway/primary/central)
"ai" = (
/turf/open/floor/engine/airless,
/area/station/hallway/primary/central)
"aj" = (
/turf/open/floor/engine/n2o,
/area/station/hallway/primary/central)
"ak" = (
/obj/item/card/id/advanced/debug,
/obj/structure/rack,
/turf/open/floor/iron,
/area/station/hallway/primary/central)
"al" = (
/obj/machinery/power/rtg/debug,
/obj/structure/cable,
/obj/effect/landmark/blobstart,
/turf/open/floor/iron,
/area/station/hallway/primary/central)
"am" = (
/obj/machinery/door/poddoor{
	id = "c1toc2";
	name = "c1toc2"
	},
/turf/open/floor/plating,
/area/station/hallway/primary/central)
"an" = (
/obj/machinery/door/poddoor{
	id = "c2toc3";
	name = "c2toc3"
	},
/turf/open/floor/plating,
/area/station/hallway/primary/central)
"ao" = (
/obj/effect/landmark/latejoin,
/obj/effect/turf_decal/bot_red,
/turf/open/floor/iron,
/area/station/hallway/primary/central)
"ap" = (
/obj/structure/cable,
/turf/open/floor/iron,
/area/station/hallway/primary/central)
"aq" = (
/obj/machinery/light/floor/has_bulb,
/turf/open/floor/iron,
/area/station/hallway/primary/central)
"ar" = (
/obj/machinery/atmospherics/miner/plasma,
/turf/open/floor/engine/plasma,
/area/station/hallway/primary/central)
"as" = (
/obj/machinery/atmospherics/miner/n2o,
/turf/open/floor/engine/n2o,
/area/station/hallway/primary/central)
"at" = (
/obj/effect/landmark/observer_start,
/obj/effect/turf_decal/bot_red,
/turf/open/floor/iron,
/area/station/hallway/primary/central)
"au" = (
/obj/effect/turf_decal/trimline,
/obj/machinery/air_sensor/plasma_tank,
/turf/open/floor/engine/plasma,
/area/station/hallway/primary/central)
"av" = (
/obj/effect/turf_decal/trimline,
/turf/open/floor/engine/airless,
/area/station/hallway/primary/central)
"aw" = (
/obj/effect/turf_decal/trimline,
/turf/open/floor/engine/n2o,
/area/station/hallway/primary/central)
"ax" = (
/obj/effect/turf_decal/bot_red,
/obj/effect/landmark/start/assistant,
/turf/open/floor/iron,
/area/station/hallway/primary/central)
"ay" = (
/obj/machinery/power/apc/auto_name/directional/east,
/obj/structure/cable,
/turf/open/floor/iron,
/area/station/hallway/primary/central)
"az" = (
/obj/machinery/meter/turf,
/turf/open/floor/engine/plasma,
/area/station/hallway/primary/central)
"aA" = (
/obj/machinery/meter/turf,
/turf/open/floor/engine/airless,
/area/station/hallway/primary/central)
"aB" = (
/obj/machinery/meter/turf,
/turf/open/floor/engine/n2o,
/area/station/hallway/primary/central)
"aC" = (
/obj/item/card/id/advanced/gold/captains_spare,
/obj/item/card/id/advanced/gold/captains_spare,
/obj/item/card/id/advanced/gold/captains_spare,
/obj/structure/rack,
/turf/open/floor/iron,
/area/station/hallway/primary/central)
"aD" = (
/obj/machinery/button/door{
	id = "c1toc2";
	name = "c1toc2"
	},
/turf/closed/wall/r_wall,
/area/station/hallway/primary/central)
"aE" = (
/obj/machinery/button/door{
	id = "c2toc3";
	name = "c2toc3"
	},
/turf/closed/wall/r_wall,
/area/station/hallway/primary/central)
"aF" = (
/obj/machinery/button/door{
	id = "c1vent";
	name = "c1vent"
	},
/turf/open/floor/iron,
/area/station/hallway/primary/central)
"aG" = (
/obj/machinery/button/door{
	id = "c2vent";
	name = "c2vent"
	},
/turf/open/floor/iron,
/area/station/hallway/primary/central)
"aH" = (
/obj/machinery/button/door{
	id = "c3vent";
	name = "c3vent"
	},
/turf/open/floor/iron,
/area/station/hallway/primary/central)
"aI" = (
/obj/structure/cable,
/obj/machinery/light/floor/has_bulb,
/turf/open/floor/iron,
/area/station/hallway/primary/central)
"aJ" = (
/obj/machinery/atmospherics/components/unary/portables_connector,
/turf/open/floor/iron,
/area/station/hallway/primary/central)
"aK" = (
/obj/machinery/portable_atmospherics/canister/plasma,
/turf/open/floor/iron,
/area/station/hallway/primary/central)
"aL" = (
/obj/machinery/portable_atmospherics/canister/oxygen,
/turf/open/floor/iron,
/area/station/hallway/primary/central)
"aM" = (
/obj/machinery/portable_atmospherics/canister/nitrogen,
/turf/open/floor/iron,
/area/station/hallway/primary/central)
"aN" = (
/obj/structure/cable,
/obj/machinery/power/rtg/debug,
/turf/open/floor/iron,
/area/station/hallway/primary/central)
"aP" = (
/obj/machinery/meter/turf,
/turf/open/floor/iron,
/area/station/hallway/primary/central)
"aS" = (
/obj/machinery/door/airlock/external/glass,
/turf/open/floor/plating,
/area/station/hallway/primary/central)
"aT" = (
/obj/machinery/gravity_generator/main,
/obj/structure/cable,
/turf/open/floor/iron,
/area/station/hallway/primary/central)
"aU" = (
/obj/machinery/light/floor/has_bulb,
/turf/open/floor/engine/plasma,
/area/station/hallway/primary/central)
"aV" = (
/obj/machinery/light/floor/has_bulb,
/turf/open/floor/engine/airless,
/area/station/hallway/primary/central)
"aW" = (
/obj/machinery/light/floor/has_bulb,
/turf/open/floor/engine/n2o,
/area/station/hallway/primary/central)
"aX" = (
/obj/machinery/atmospherics/components/unary/portables_connector{
	icon_state = "connector_map-3";
	dir = 4
	},
/turf/open/floor/plating,
/area/station/hallway/primary/central)
"aY" = (
/obj/machinery/atmospherics/components/binary/pump{
	icon_state = "pump_map-3";
	dir = 8
	},
/turf/open/floor/plating,
/area/station/hallway/primary/central)
"aZ" = (
/obj/machinery/atmospherics/components/unary/portables_connector{
	icon_state = "connector_map-3";
	dir = 8
	},
/turf/open/floor/plating,
/area/station/hallway/primary/central)
"ba" = (
/obj/machinery/atmospherics/components/binary/volume_pump{
	icon_state = "volpump_map-3";
	dir = 8
	},
/turf/open/floor/plating,
/area/station/hallway/primary/central)
"bb" = (
/obj/machinery/atmospherics/components/binary/valve{
	dir = 8
	},
/turf/open/floor/plating,
/area/station/hallway/primary/central)
"bc" = (
/obj/effect/turf_decal/stripes/red/line{
	icon_state = "warningline_red";
	dir = 4
	},
/obj/machinery/atmospherics/components/unary/portables_connector{
	icon_state = "connector_map-3";
	dir = 8
	},
/turf/open/floor/plating,
/area/station/hallway/primary/central)
"bd" = (
/obj/item/pipe_dispenser,
/obj/structure/table/reinforced,
/obj/item/debug/omnitool,
/obj/item/door_remote/omni,
/turf/open/floor/iron,
/area/station/hallway/primary/central)
"be" = (
/obj/machinery/pipedispenser,
/turf/open/floor/iron,
/area/station/hallway/primary/central)
"bf" = (
/obj/machinery/light/floor/has_bulb,
/turf/open/floor/plating,
/area/station/hallway/primary/central)
"bg" = (
/obj/effect/turf_decal/stripes/red/line{
	icon_state = "warningline_red";
	dir = 4
	},
/turf/open/floor/plating,
/area/station/hallway/primary/central)
"bh" = (
/obj/effect/turf_decal/stripes/red/line,
/turf/open/floor/plating,
/area/station/hallway/primary/central)
"bi" = (
/obj/effect/turf_decal/stripes/red/line,
/obj/machinery/atmospherics/components/unary/portables_connector{
	icon_state = "connector_map-3";
	dir = 4
	},
/turf/open/floor/plating,
/area/station/hallway/primary/central)
"bj" = (
/obj/effect/turf_decal/stripes/red/line,
/obj/machinery/atmospherics/pipe/smart/simple/general/visible,
/turf/open/floor/plating,
/area/station/hallway/primary/central)
"bk" = (
/obj/effect/turf_decal/stripes/red/line,
/obj/machinery/atmospherics/components/unary/portables_connector{
	icon_state = "connector_map-3";
	dir = 8
	},
/turf/open/floor/plating,
/area/station/hallway/primary/central)
"bl" = (
/obj/effect/turf_decal/stripes/red/line,
/obj/machinery/atmospherics/components/binary/valve/digital{
	icon_state = "dvalve_map-3";
	dir = 8
	},
/turf/open/floor/plating,
/area/station/hallway/primary/central)
"bm" = (
/obj/effect/turf_decal/stripes/red/line,
/obj/machinery/atmospherics/components/binary/passive_gate{
	icon_state = "passgate_map-3";
	dir = 8
	},
/turf/open/floor/plating,
/area/station/hallway/primary/central)
"bn" = (
/obj/effect/turf_decal/stripes/red/line{
	icon_state = "warningline_red";
	dir = 9
	},
/obj/machinery/atmospherics/components/unary/portables_connector{
	icon_state = "connector_map-3";
	dir = 8
	},
/turf/open/floor/plating,
/area/station/hallway/primary/central)
"bo" = (
/obj/machinery/portable_atmospherics/canister,
/obj/effect/turf_decal/trimline/yellow/filled,
/turf/open/floor/iron,
/area/station/hallway/primary/central)
"bp" = (
/obj/machinery/light/floor/has_bulb,
/obj/machinery/portable_atmospherics/canister,
/obj/effect/turf_decal/trimline/yellow/filled,
/turf/open/floor/iron,
/area/station/hallway/primary/central)
"bq" = (
/obj/machinery/portable_atmospherics/canister/oxygen,
/obj/effect/turf_decal/trimline/blue/filled,
/turf/open/floor/iron,
/area/station/hallway/primary/central)
"br" = (
/obj/effect/turf_decal/stripes/red/line{
	icon_state = "warningline_red";
	dir = 6
	},
/obj/machinery/atmospherics/pipe/smart/simple/general/visible,
/turf/open/floor/plating,
/area/station/hallway/primary/central)
"bs" = (
/obj/effect/turf_decal/stripes/red/line{
	icon_state = "warningline_red";
	dir = 1
	},
/obj/machinery/atmospherics/pipe/smart/simple/general/visible,
/obj/machinery/meter,
/turf/open/floor/plating,
/area/station/hallway/primary/central)
"bt" = (
/obj/effect/turf_decal/stripes/red/line{
	icon_state = "warningline_red";
	dir = 10
	},
/obj/machinery/atmospherics/pipe/smart/simple/general/visible,
/turf/open/floor/plating,
/area/station/hallway/primary/central)
"bu" = (
/obj/effect/turf_decal/stripes/red/line{
	icon_state = "warningline_red";
	dir = 8
	},
/obj/machinery/atmospherics/pipe/smart/simple/general/visible,
/turf/open/floor/plating,
/area/station/hallway/primary/central)
"bv" = (
/obj/effect/turf_decal/stripes/red/line{
	icon_state = "warningline_red";
	dir = 4
	},
/obj/machinery/atmospherics/pipe/smart/simple/general/visible,
/turf/open/floor/plating,
/area/station/hallway/primary/central)
"bw" = (
/obj/effect/turf_decal/stripes/red/line{
	icon_state = "warningline_red";
	dir = 5
	},
/obj/machinery/atmospherics/pipe/smart/simple/general/visible,
/turf/open/floor/plating,
/area/station/hallway/primary/central)
"bx" = (
/obj/effect/turf_decal/stripes/red/line,
/obj/machinery/atmospherics/pipe/smart/simple/general/visible,
/obj/machinery/meter,
/turf/open/floor/plating,
/area/station/hallway/primary/central)
"by" = (
/obj/effect/turf_decal/stripes/red/line{
	icon_state = "warningline_red";
	dir = 9
	},
/obj/machinery/atmospherics/pipe/smart/simple/general/visible,
/turf/open/floor/plating,
/area/station/hallway/primary/central)
"bz" = (
/obj/machinery/door/airlock/public/glass,
/turf/open/floor/iron,
/area/station/hallway/primary/central)
"bA" = (
/obj/structure/cable,
/obj/effect/turf_decal/arrows,
/obj/machinery/light/floor/has_bulb,
/turf/open/floor/iron,
/area/station/hallway/primary/central)
"bB" = (
/obj/structure/cable,
/turf/open/floor/plating,
/area/station/hallway/primary/central)
"bC" = (
/obj/structure/cable,
/obj/effect/turf_decal/arrows{
	icon_state = "arrows";
	dir = 4
	},
/turf/open/floor/iron,
/area/station/hallway/primary/central)
"bD" = (
/obj/item/pipe_dispenser,
/obj/structure/table/reinforced,
/turf/open/floor/iron,
/area/station/hallway/primary/central)
"bE" = (
/obj/item/holosign_creator/atmos,
/obj/structure/table/reinforced,
/turf/open/floor/iron,
/area/station/hallway/primary/central)
"bF" = (
/obj/machinery/portable_atmospherics/pump,
/turf/open/floor/iron,
/area/station/hallway/primary/central)
"bG" = (
/obj/machinery/portable_atmospherics/scrubber,
/turf/open/floor/iron,
/area/station/hallway/primary/central)
"bH" = (
/obj/structure/table/reinforced,
/obj/item/debug/omnitool,
/obj/item/door_remote/omni,
/turf/open/floor/iron,
/area/station/hallway/primary/central)
"bI" = (
/obj/machinery/air_sensor/mix_tank,
/turf/open/floor/engine/airless,
/area/station/hallway/primary/central)
"bJ" = (
/obj/effect/turf_decal/trimline,
/obj/machinery/air_sensor/nitrous_tank,
/turf/open/floor/engine/n2o,
/area/station/hallway/primary/central)
"bK" = (
/obj/machinery/atmospherics/components/unary/vent_pump/siphon/monitored/plasma_output,
/turf/open/floor/engine/plasma,
/area/station/hallway/primary/central)
"bL" = (
/obj/machinery/atmospherics/components/unary/vent_pump/siphon/monitored/mix_output,
/turf/open/floor/engine/airless,
/area/station/hallway/primary/central)
"bM" = (
/obj/machinery/atmospherics/components/unary/vent_pump/siphon/monitored/nitrous_output,
/turf/open/floor/engine/n2o,
/area/station/hallway/primary/central)
"bN" = (
/obj/effect/spawner/structure/window/plasma,
/obj/machinery/atmospherics/pipe/smart/simple/orange/visible,
/turf/open/floor/plating,
/area/station/hallway/primary/central)
"bO" = (
/obj/effect/spawner/structure/window/plasma,
/obj/machinery/atmospherics/pipe/smart/simple/dark/visible,
/turf/open/floor/plating,
/area/station/hallway/primary/central)
"bP" = (
/obj/effect/spawner/structure/window/plasma,
/obj/machinery/atmospherics/pipe/smart/simple/pink/visible,
/turf/open/floor/plating,
/area/station/hallway/primary/central)
"bQ" = (
/obj/machinery/portable_atmospherics/canister/plasma,
/obj/machinery/atmospherics/pipe/smart/simple/orange/visible,
/turf/open/floor/iron,
/area/station/hallway/primary/central)
"bR" = (
/obj/machinery/computer/atmos_control/plasma_tank,
/obj/machinery/light/floor/has_bulb,
/turf/open/floor/iron,
/area/station/hallway/primary/central)
"bS" = (
/obj/machinery/atmospherics/pipe/smart/simple/dark/visible,
/turf/open/floor/iron,
/area/station/hallway/primary/central)
"bT" = (
/obj/machinery/computer/atmos_control/mix_tank,
/obj/machinery/light/floor/has_bulb,
/turf/open/floor/iron,
/area/station/hallway/primary/central)
"bU" = (
/obj/machinery/atmospherics/pipe/smart/simple/pink/visible,
/turf/open/floor/iron,
/area/station/hallway/primary/central)
"bV" = (
/obj/machinery/computer/atmos_control/nitrous_tank,
/obj/machinery/light/floor/has_bulb,
/turf/open/floor/iron,
/area/station/hallway/primary/central)
"bW" = (
/obj/machinery/atmospherics/pipe/smart/simple/orange/visible,
/turf/open/floor/iron,
/area/station/hallway/primary/central)
"bX" = (
/obj/machinery/atmospherics/components/unary/portables_connector{
	icon_state = "connector_map-3";
	dir = 1
	},
/turf/open/floor/iron,
/area/station/hallway/primary/central)
"bY" = (
/obj/structure/cable,
/obj/machinery/door/airlock/public/glass{
	name = "Power"
	},
/turf/open/floor/iron,
/area/station/hallway/primary/central)
"bZ" = (
/obj/structure/cable,
/obj/machinery/door/airlock/public/glass{
	name = "Main Floor"
	},
/turf/open/floor/iron,
/area/station/hallway/primary/central)
"ca" = (
/obj/machinery/light/floor/has_bulb,
/obj/structure/cable,
/turf/open/floor/iron,
/area/station/hallway/primary/central)
"cb" = (
/obj/machinery/door/airlock/public/glass{
	name = "Basic Equipment Tests"
	},
/turf/open/floor/iron,
/area/station/hallway/primary/central)
"cc" = (
/obj/effect/spawner/structure/window/plasma,
/obj/machinery/atmospherics/pipe/heat_exchanging/junction{
	icon_state = "pipe11-3";
	dir = 1
	},
/turf/open/floor/plating,
/area/station/hallway/primary/central)
"cd" = (
/obj/machinery/atmospherics/components/unary/portables_connector{
	icon_state = "connector_map-3";
	dir = 4
	},
/obj/machinery/portable_atmospherics/canister/nitrous_oxide,
/turf/open/floor/iron,
/area/station/hallway/primary/central)
"ce" = (
/obj/machinery/atmospherics/pipe/smart/manifold/general/visible{
	icon_state = "manifold-3";
	dir = 4
	},
/turf/open/floor/iron,
/area/station/hallway/primary/central)
"cf" = (
/obj/machinery/atmospherics/components/trinary/filter/atmos/flipped/co2{
	icon_state = "filter_on-0_f";
	dir = 1
	},
/turf/open/floor/iron,
/area/station/hallway/primary/central)
"cg" = (
/obj/machinery/atmospherics/components/unary/portables_connector{
	icon_state = "connector_map-3";
	dir = 8
	},
/turf/open/floor/iron,
/area/station/hallway/primary/central)
"ch" = (
/obj/machinery/atmospherics/components/unary/portables_connector{
	icon_state = "connector_map-3";
	dir = 4
	},
/obj/machinery/portable_atmospherics/canister,
/turf/open/floor/iron,
/area/station/hallway/primary/central)
"ci" = (
/obj/machinery/atmospherics/components/trinary/filter/atmos/flipped/h2{
	icon_state = "filter_on-0_f";
	dir = 1
	},
/turf/open/floor/iron,
/area/station/hallway/primary/central)
"cj" = (
/obj/machinery/atmospherics/components/unary/thermomachine/freezer,
/turf/open/floor/plating,
/area/station/hallway/primary/central)
"ck" = (
/turf/open/floor/plating,
/area/station/hallway/primary/central)
"cl" = (
/obj/machinery/atmospherics/components/unary/portables_connector{
	icon_state = "connector_map-3";
	dir = 1
	},
/turf/open/floor/plating,
/area/station/hallway/primary/central)
"cm" = (
/obj/machinery/atmospherics/pipe/heat_exchanging/simple{
	icon_state = "pipe11-3";
	dir = 6
	},
/turf/open/space/basic,
/area/space)
"cn" = (
/obj/machinery/atmospherics/pipe/heat_exchanging/simple{
	icon_state = "pipe11-3";
	dir = 10
	},
/turf/open/space/basic,
/area/space)
"co" = (
/obj/machinery/atmospherics/pipe/heat_exchanging/simple,
/turf/open/space/basic,
/area/space)
"cp" = (
/obj/machinery/atmospherics/pipe/heat_exchanging/simple{
	icon_state = "pipe11-3";
	dir = 5
	},
/turf/open/space/basic,
/area/space)
"cq" = (
/obj/machinery/atmospherics/pipe/heat_exchanging/simple{
	icon_state = "pipe11-3";
	dir = 9
	},
/turf/open/space/basic,
/area/space)
"cr" = (
/obj/machinery/atmospherics/components/unary/thermomachine/heater,
/turf/open/floor/plating,
/area/station/hallway/primary/central)
"cs" = (
/obj/structure/table/reinforced,
/obj/item/analyzer,
/turf/open/floor/iron,
/area/station/hallway/primary/central)
"ct" = (
/obj/effect/landmark/start/assistant,
/obj/effect/turf_decal/bot_red,
/turf/open/floor/iron,
/area/station/hallway/primary/central)
"cu" = (
/obj/structure/table/reinforced,
/obj/item/clothing/glasses/debug,
/obj/item/clothing/glasses/debug,
/obj/item/clothing/glasses/debug,
/obj/item/clothing/glasses/debug,
/obj/item/clothing/glasses/debug,
/turf/open/floor/iron,
/area/station/hallway/primary/central)
"cv" = (
/obj/structure/table/reinforced,
/obj/item/debug/omnitool,
/obj/item/debug/omnitool,
/obj/item/debug/omnitool,
/turf/open/floor/iron,
/area/station/hallway/primary/central)
"cw" = (
/obj/structure/table/reinforced,
/obj/item/gun/magic/wand/death/debug,
/obj/item/gun/magic/wand/death/debug,
/obj/item/gun/magic/wand/resurrection/debug,
/obj/item/gun/magic/wand/safety/debug,
/obj/item/gun/magic/wand/safety/debug,
/turf/open/floor/iron,
/area/station/hallway/primary/central)
"cx" = (
/obj/structure/table/reinforced,
/obj/item/mod/control/pre_equipped/debug,
/turf/open/floor/iron,
/area/station/hallway/primary/central)
"cy" = (
/obj/structure/table/reinforced,
/obj/item/storage/box/debugtools,
/obj/item/storage/box/debugtools,
/obj/item/storage/box/debugtools,
/obj/item/storage/box/debugtools,
/obj/item/storage/box/debugtools,
/turf/open/floor/iron,
/area/station/hallway/primary/central)
"cz" = (
/obj/structure/cable,
/obj/machinery/door/airlock/public/glass{
	name = "Gravgen"
	},
/turf/open/floor/iron,
/area/station/hallway/primary/central)
"cA" = (
/obj/machinery/atmospherics/components/unary/portables_connector{
	icon_state = "connector_map-3";
	dir = 4
	},
/obj/machinery/portable_atmospherics/canister/nitrogen,
/turf/open/floor/iron,
/area/station/hallway/primary/central)
"cB" = (
/obj/machinery/atmospherics/components/trinary/filter/atmos/flipped/n2{
	icon_state = "filter_on-0_f";
	dir = 1
	},
/turf/open/floor/iron,
/area/station/hallway/primary/central)
"cC" = (
/obj/machinery/atmospherics/components/unary/portables_connector{
	icon_state = "connector_map-3";
	dir = 4
	},
/obj/machinery/portable_atmospherics/canister/oxygen,
/turf/open/floor/iron,
/area/station/hallway/primary/central)
"cD" = (
/obj/machinery/atmospherics/components/trinary/filter/atmos/flipped/o2{
	icon_state = "filter_on-0_f";
	dir = 1
	},
/turf/open/floor/iron,
/area/station/hallway/primary/central)
"cE" = (
/obj/machinery/atmospherics/components/unary/portables_connector{
	icon_state = "connector_map-3";
	dir = 4
	},
/obj/machinery/portable_atmospherics/canister/plasma,
/turf/open/floor/iron,
/area/station/hallway/primary/central)
"cF" = (
/obj/machinery/atmospherics/components/trinary/filter/atmos/flipped/plasma{
	icon_state = "filter_on-0_f";
	dir = 1
	},
/turf/open/floor/iron,
/area/station/hallway/primary/central)
"cG" = (
/obj/machinery/atmospherics/components/binary/volume_pump,
/turf/open/floor/iron,
/area/station/hallway/primary/central)
"cH" = (
/obj/machinery/atmospherics/components/unary/portables_connector{
	icon_state = "connector_map-3";
	dir = 1
	},
/obj/machinery/portable_atmospherics/canister,
/turf/open/floor/iron,
/area/station/hallway/primary/central)
"cI" = (
/obj/machinery/light/floor/has_bulb,
/obj/machinery/atmospherics/components/unary/passive_vent,
/turf/open/floor/iron,
/area/station/hallway/primary/central)
"cJ" = (
/obj/machinery/atmospherics/pipe/smart/simple/general/visible,
/turf/open/floor/iron,
/area/station/hallway/primary/central)
"cK" = (
/obj/machinery/door/airlock/public/glass,
/obj/machinery/atmospherics/pipe/smart/simple/general/visible,
/turf/open/floor/iron,
/area/station/hallway/primary/central)
"cL" = (
/obj/machinery/atmospherics/components/unary/cryo_cell,
/turf/open/floor/iron,
/area/station/hallway/primary/central)
"cM" = (
/obj/machinery/light/floor/has_bulb,
/obj/machinery/atmospherics/components/unary/passive_vent{
	icon_state = "passive_vent_map-3";
	dir = 1
	},
/turf/open/floor/iron,
/area/station/hallway/primary/central)
"cN" = (
/obj/machinery/atmospherics/components/unary/heat_exchanger{
	icon_state = "he1";
	dir = 8
	},
/turf/open/floor/plating,
/area/station/hallway/primary/central)
"cO" = (
/obj/machinery/atmospherics/components/unary/heat_exchanger{
	icon_state = "he1";
	dir = 4
	},
/turf/open/floor/plating,
/area/station/hallway/primary/central)
"cP" = (
/obj/machinery/atmospherics/components/binary/circulator/cold{
	icon_state = "circ-off-0";
	dir = 4
	},
/obj/structure/cable,
/turf/open/floor/iron,
/area/station/hallway/primary/central)
"cQ" = (
/obj/machinery/power/generator,
/obj/structure/cable,
/turf/open/floor/iron,
/area/station/hallway/primary/central)
"cR" = (
/obj/machinery/atmospherics/components/binary/circulator{
	icon_state = "circ-off-0";
	dir = 8
	},
/obj/structure/cable,
/turf/open/floor/iron,
/area/station/hallway/primary/central)
"cS" = (
/obj/machinery/atmospherics/components/unary/portables_connector{
	icon_state = "connector_map-3";
	dir = 4
	},
/turf/open/floor/iron,
/area/station/hallway/primary/central)
"cT" = (
/obj/machinery/atmospherics/components/trinary/mixer,
/turf/open/floor/iron,
/area/station/hallway/primary/central)
"cU" = (
/obj/machinery/atmospherics/components/binary/tank_compressor,
/turf/open/floor/iron,
/area/station/hallway/primary/central)
"cV" = (
/obj/item/storage/toolbox/mechanical,
/turf/open/floor/iron,
/area/station/hallway/primary/central)

(1,1,1) = {"
aa
aa
aa
aa
aa
aa
aa
aa
aa
aa
aa
aa
aa
aa
aa
aa
aa
aa
aa
aa
aa
aa
aa
aa
aa
aa
aa
aa
aa
aa
aa
aa
aa
aa
aa
aa
aa
aa
aa
aa
aa
"}
(2,1,1) = {"
aa
ab
ab
ac
ac
ac
ab
ab
ab
ac
ac
ac
ac
ac
ac
ac
ac
ac
ac
ac
ab
ab
ab
ac
ac
ac
ac
ac
ac
ac
ac
ab
ab
ab
ab
ac
ac
ac
ab
ab
aa
"}
(3,1,1) = {"
aa
ab
ag
ag
ag
ag
ag
ab
ct
ct
ct
ct
ct
ct
ct
ct
ct
ct
ct
ag
ag
ab
ck
ck
bh
ag
bo
bo
bo
bo
bo
ag
ag
ab
ag
ag
ag
ag
ag
ab
aa
"}
(4,1,1) = {"
aa
ac
ag
al
aN
al
ag
ac
ag
ag
ag
ag
ag
ag
ag
ag
ag
ag
ag
aI
ag
ac
ck
bf
bh
ag
bp
bo
bo
bo
bp
ag
ag
ac
ag
ag
aq
ag
ag
ac
aa
"}
(5,1,1) = {"
aa
ac
ag
ag
aq
ap
ap
bY
ap
ap
bA
ap
bA
ap
bA
ap
bA
ap
bA
ap
ag
ac
ck
ck
bh
ag
ag
ag
ag
ag
ag
ag
ag
bz
ag
ag
aP
ag
ag
ac
aa
"}
(6,1,1) = {"
aa
ac
ag
al
aN
al
ag
ac
ag
ag
ag
ag
ag
ag
ag
ag
ag
ag
ag
ap
ag
ac
aX
ck
bi
ag
bq
bq
bq
bq
bq
ag
ag
ac
ag
ag
ag
ag
ag
ac
aa
"}
(7,1,1) = {"
aa
ab
ag
ag
ag
ap
ay
ab
ak
ao
at
ax
aC
cu
cv
cw
cx
cy
ag
bC
ag
ab
aY
ck
bj
ag
bq
bq
bq
bq
bq
ag
ag
ab
ag
ag
ag
ag
ag
ab
aa
"}
(8,1,1) = {"
aa
ab
ab
ac
ac
ac
ab
ab
ab
ac
ac
ac
ac
ac
ac
ac
ab
ab
ab
bZ
ab
ab
aZ
ck
bk
ag
ag
ag
ag
ag
ag
ag
ag
ab
ab
ac
bz
ac
ab
ab
aa
"}
(9,1,1) = {"
aa
ab
aU
ah
ah
ah
aU
ab
aK
aK
aL
aL
aL
aM
aM
aM
be
ab
bF
ap
ag
ab
aX
ck
bi
ag
ag
ag
ag
ag
ag
ag
ag
ab
ag
ag
ag
ag
ag
ab
aa
"}
(10,1,1) = {"
aa
ad
ah
ah
ah
ah
bK
bN
bQ
bW
bX
ag
ag
ag
ag
ag
ag
bD
bG
ap
ag
ac
ba
bf
bl
ag
aq
ag
ag
ag
aq
ag
ag
ac
ag
ag
ag
ag
ag
ac
aa
"}
(11,1,1) = {"
aa
ad
ah
ah
ar
au
az
ac
aF
ag
ag
ag
ag
ag
ag
ag
ag
bE
bH
aI
ag
ac
aZ
ck
bk
ag
ag
aX
ag
ag
ag
ag
ag
ac
ag
ag
ag
ag
ag
ac
aa
"}
(12,1,1) = {"
aa
ad
ah
ah
ah
ah
ah
ac
bR
ag
ag
aq
ag
ag
aq
ag
ag
aq
ag
ap
ag
ac
aX
ck
bi
ag
br
bu
bw
ag
ag
ag
ag
bz
ag
ag
aP
ag
ag
ac
aa
"}
(13,1,1) = {"
aa
ab
aU
ah
ah
ah
aU
ab
ag
ag
ag
ag
ag
ag
ag
ag
ag
ag
ag
ap
ag
ac
bb
ck
bm
ag
bs
ck
bx
ag
ag
ag
ag
ac
ag
ag
aq
ag
ag
ac
aa
"}
(14,1,1) = {"
aa
ab
ab
am
am
am
ab
aD
ag
ag
ag
ag
ag
ag
ag
ag
ag
ag
ag
ap
ag
ab
bc
bg
bn
ag
bt
bv
by
ag
cS
ag
ag
ac
ag
ag
ag
ag
ag
ac
aa
"}
(15,1,1) = {"
aa
ab
aV
ai
ai
ai
aV
ab
ag
ag
ag
ag
ag
ag
ag
ag
ag
ag
ag
ap
ag
cb
ag
ag
ag
ag
ag
aZ
ag
aJ
cT
bX
ag
ab
ag
ag
ag
ag
ag
ab
aa
"}
(16,1,1) = {"
aa
ae
ai
ai
ai
av
bL
bO
bS
bS
bX
ag
ag
ag
ag
ag
ag
bB
ag
ap
ag
cb
ag
aq
ag
ag
aq
ag
ag
ag
aq
ag
ag
ab
ab
ac
bz
ac
ab
ab
aa
"}
(17,1,1) = {"
aa
ae
ai
ai
ai
bI
aA
ac
aG
ag
ag
aq
ag
ag
aq
ag
aq
bB
ap
aI
ag
cb
ag
ag
ag
cd
ch
cA
cC
cE
ag
ag
ag
ab
ag
ag
ag
ag
ag
ab
aa
"}
(18,1,1) = {"
aa
ae
ai
ai
ai
av
ai
ac
bT
ag
ag
ag
ag
ag
ag
ag
ag
bB
ag
ap
ag
ab
bd
ag
aJ
ce
ce
ce
ce
ce
cG
cH
ag
ac
ag
ag
ag
ag
ag
ac
aa
"}
(19,1,1) = {"
aa
ab
aV
ai
ai
ai
aV
ab
ag
ag
ag
ag
ag
ag
ag
ag
ag
ag
ag
ap
ag
ac
aK
ag
aJ
cf
ci
cB
cD
cF
bX
ag
ag
bz
ag
ag
aq
ag
ag
ac
aa
"}
(20,1,1) = {"
aa
ab
ab
an
an
an
ab
aE
ag
ag
ag
ag
ag
ag
ag
ag
ag
ag
ag
ap
ag
ac
aK
ag
ag
cg
cg
cg
cg
cg
ag
ag
ag
ac
ag
ag
aP
ag
ag
ac
aa
"}
(21,1,1) = {"
aa
ab
aW
aj
aj
aj
aW
ab
ag
ag
ag
ag
ag
ag
ag
ag
ag
ag
ag
ap
ag
ac
aK
aq
ag
ag
aq
ag
ag
ag
aq
ag
ag
ac
ag
ag
ag
ag
ag
ac
aa
"}
(22,1,1) = {"
aa
af
aj
aj
aj
aw
bM
bP
bU
bU
bX
ag
ag
ag
ag
ag
ag
ag
ag
ap
ag
ac
aL
ag
ag
ag
ag
ag
ag
aX
ag
ag
ag
ab
ag
ag
ag
ag
ag
ab
aa
"}
(23,1,1) = {"
aa
af
aj
aj
as
bJ
aB
ac
aH
ag
ag
aq
ag
ag
aq
ag
ag
aq
ag
aI
ag
ac
aL
ag
ag
ag
cj
cl
ag
cN
ag
ag
cU
ab
ab
ac
bz
ac
ab
ab
aa
"}
(24,1,1) = {"
aa
af
aj
aj
aj
aw
aj
ac
bV
ag
ag
ag
ag
aJ
cP
bX
ag
ag
ag
ap
ag
ac
aL
ag
ag
ag
cr
cl
ag
cO
ag
ag
ag
ab
ag
ag
ag
ag
ag
ab
aa
"}
(25,1,1) = {"
aa
ab
aW
aj
aj
aj
aW
ab
ag
ag
ag
ag
ag
ag
cQ
cV
ag
ag
ag
ap
ag
ac
aM
ag
ag
ag
ag
ag
ag
aZ
ag
ag
ag
ac
ag
ag
ag
ag
ag
ac
aa
"}
(26,1,1) = {"
aa
ab
ab
ac
ac
ac
ab
ab
ag
ag
ag
ag
ag
aJ
cR
bX
ag
ag
ag
ap
ag
ac
aM
ag
ag
ag
cL
bX
ag
ag
ag
ag
ag
bz
ag
ag
aP
ag
ag
aS
aa
"}
(27,1,1) = {"
aa
ab
aq
ag
ag
ag
aq
ab
aq
ag
ag
aq
ag
ag
ca
ag
ag
aq
ag
ca
ag
ac
aM
aq
ag
ag
aq
ag
ag
ag
aq
ag
ag
ac
ag
ag
aq
ag
ag
ac
aa
"}
(28,1,1) = {"
aa
ac
ag
ag
ag
ag
ag
ac
ag
ag
ag
ag
ag
ag
ap
ag
ag
ag
ag
ap
ag
ac
be
ag
ag
ag
ag
ag
ag
ag
ag
ag
ag
ab
ag
ag
ag
ag
ag
ab
aa
"}
(29,1,1) = {"
aa
ac
ag
ag
ag
aT
ap
cz
ap
ap
ap
ap
ap
ap
ap
ap
ap
ap
ap
ap
ag
ab
ac
bz
ac
ab
ac
bz
ac
ab
ac
bz
ac
ab
ab
ac
aS
ac
ab
ab
aa
"}
(30,1,1) = {"
aa
ac
ag
ag
ag
ag
ag
ac
ag
ag
ag
ag
ag
ag
ag
ag
ag
ag
ag
ag
ag
ac
ag
ag
aP
ac
ag
ag
aP
ac
ag
ag
ag
ac
aa
aa
aa
aa
aa
aa
aa
"}
(31,1,1) = {"
aa
ab
aq
ag
ag
ag
aq
ab
ag
ag
ag
aq
ag
ag
aq
ag
ag
aq
ag
aq
ag
ac
ag
cI
cJ
cK
cJ
cM
ag
bz
ag
aq
ag
ac
aa
aa
aa
aa
aa
aa
aa
"}
(32,1,1) = {"
aa
ab
ab
ac
ac
ac
ab
ab
aq
ag
ag
ag
ag
ag
ag
ag
ag
ag
ag
ag
ag
ac
ag
ag
ag
ac
ag
ag
ag
ac
ag
ag
ag
ac
aa
aa
aa
aa
aa
aa
aa
"}
(33,1,1) = {"
aa
aa
aa
aa
aa
aa
ab
cs
ag
ag
ag
ag
ag
ag
ag
ag
ag
ag
ag
ag
ag
ab
ac
bz
ac
ab
ac
bz
ac
ab
ag
aP
ag
ab
aa
aa
aa
aa
aa
aa
aa
"}
(34,1,1) = {"
aa
aa
aa
cm
co
co
cc
bX
ag
ag
ag
ag
ag
ag
ag
ag
ag
ag
ag
ag
ag
ac
ag
ag
aP
ac
ag
ag
aP
ac
ag
ag
ag
ac
aa
aa
aa
aa
aa
aa
aa
"}
(35,1,1) = {"
aa
aa
aa
cn
co
cp
ac
aK
ag
ag
ag
aq
ag
ag
aq
ag
ag
aq
ag
aq
ag
ac
ag
aq
ag
bz
ag
aq
ag
bz
ag
aq
ag
ac
aa
aa
aa
aa
aa
aa
aa
"}
(36,1,1) = {"
aa
aa
aa
cm
co
cq
ac
aK
ag
ag
ag
ag
ag
ag
ag
ag
ag
ag
ag
ag
ag
ac
ag
ag
ag
ac
ag
ag
ag
ac
ag
ag
ag
ac
aa
aa
aa
aa
aa
aa
aa
"}
(37,1,1) = {"
aa
aa
aa
cn
co
co
cc
bX
ag
ag
ag
ag
ag
ag
ag
ag
ag
ag
ag
ag
ag
ab
ac
aS
ac
ab
ac
aS
ac
ab
ac
aS
ac
ab
aa
aa
aa
aa
aa
aa
aa
"}
(38,1,1) = {"
aa
aa
aa
aa
aa
aa
ab
aq
ag
ag
ag
ag
ag
ag
ag
ag
ag
ag
ag
ag
aq
ab
aa
aa
aa
aa
aa
aa
aa
aa
aa
aa
aa
aa
aa
aa
aa
aa
aa
aa
aa
"}
(39,1,1) = {"
aa
aa
aa
aa
aa
aa
ab
ab
ac
ac
ac
ab
ac
ac
ac
ac
ab
ac
ac
ac
ab
ab
aa
aa
aa
aa
aa
aa
aa
aa
aa
aa
aa
aa
aa
aa
aa
aa
aa
aa
aa
"}
(40,1,1) = {"
aa
aa
aa
aa
aa
aa
aa
aa
aa
aa
aa
aa
aa
aa
aa
aa
aa
aa
aa
aa
aa
aa
aa
aa
aa
aa
aa
aa
aa
aa
aa
aa
aa
aa
aa
aa
aa
aa
aa
aa
aa
"}
