//MAP CONVERTED BY dmm2tgm.py THIS HEADER COMMENT PREVENTS RECONVERSION, DO NOT REMOVE
"aa" = (
/turf/template_noop,
/area/template_noop)
"ab" = (
/obj/machinery/porta_turret/syndicate/shuttle{
	dir = 9
	},
/turf/closed/wall/r_wall/syndicate,
/area/shuttle/syndicate/bridge)
"ac" = (
/turf/closed/wall/r_wall/syndicate,
/area/shuttle/syndicate/bridge)
"ad" = (
/obj/machinery/porta_turret/syndicate/shuttle{
	dir = 10
	},
/turf/closed/wall/r_wall/syndicate,
/area/shuttle/syndicate/hallway)
"ae" = (
/obj/effect/spawner/structure/window/reinforced/plasma/plastitanium,
/obj/machinery/door/poddoor/shutters{
	id = "syndieshutters";
	name = "blast shutters"
	},
/turf/open/floor/plating,
/area/shuttle/syndicate/bridge)
"af" = (
/turf/closed/wall/r_wall/syndicate,
/area/shuttle/syndicate/hallway)
"ag" = (
/obj/item/clipboard,
/obj/item/folder/red,
/obj/structure/table/reinforced/plastitaniumglass,
/turf/open/floor/iron/dark,
/area/shuttle/syndicate/bridge)
"ah" = (
/obj/item/storage/fancy/donut_box,
/obj/structure/table/reinforced/plastitaniumglass,
/turf/open/floor/iron/dark,
/area/shuttle/syndicate/bridge)
"ai" = (
/obj/machinery/computer/camera_advanced/shuttle_docker/syndicate,
/turf/open/floor/iron/dark,
/area/shuttle/syndicate/bridge)
"aj" = (
/obj/machinery/computer/shuttle/syndicate,
/turf/open/floor/iron/dark,
/area/shuttle/syndicate/bridge)
"ak" = (
/obj/structure/overfloor_catwalk/iron_dark,
/turf/open/floor/plating,
/area/shuttle/syndicate/hallway)
"al" = (
/obj/machinery/computer/camera_advanced/syndie,
/turf/open/floor/iron/dark,
/area/shuttle/syndicate/bridge)
"am" = (
/obj/machinery/button/door{
	id = "syndieshutters";
	name = "Cockpit View Control";
	req_access_txt = "150";
	pixel_y = 24
	},
/obj/item/aicard,
/obj/structure/table/reinforced/plastitaniumglass,
/turf/open/floor/iron/dark,
/area/shuttle/syndicate/bridge)
"ao" = (
/obj/structure/chair/office/tactical{
	dir = 8
	},
/obj/structure/overfloor_catwalk/iron_dark,
/turf/open/floor/plating,
/area/shuttle/syndicate/bridge)
"ap" = (
/turf/open/floor/iron/dark,
/area/shuttle/syndicate/bridge)
"aq" = (
/obj/structure/chair/comfy/shuttle/tactical{
	dir = 1
	},
/turf/open/floor/iron/dark,
/area/shuttle/syndicate/bridge)
"ar" = (
/obj/structure/chair/office/tactical{
	dir = 4
	},
/obj/structure/overfloor_catwalk/iron_dark,
/turf/open/floor/plating,
/area/shuttle/syndicate/bridge)
"as" = (
/obj/effect/turf_decal/siding/thinplating_new/dark{
	dir = 4
	},
/turf/open/floor/iron/dark/textured_edge{
	dir = 4
	},
/area/shuttle/syndicate/airlock)
"aw" = (
/obj/machinery/porta_turret/syndicate/shuttle{
	dir = 9
	},
/turf/closed/wall/r_wall/syndicate,
/area/shuttle/syndicate/eva)
"ax" = (
/turf/closed/wall/r_wall/syndicate,
/area/shuttle/syndicate/eva)
"aB" = (
/turf/closed/wall/r_wall/syndicate,
/area/shuttle/syndicate/airlock)
"aD" = (
/turf/open/floor/iron/dark,
/area/shuttle/syndicate/hallway)
"aF" = (
/obj/machinery/porta_turret/syndicate/shuttle{
	dir = 5
	},
/turf/closed/wall/r_wall/syndicate,
/area/shuttle/syndicate/engineering)
"aG" = (
/obj/machinery/porta_turret/syndicate/shuttle{
	dir = 9
	},
/turf/closed/wall/r_wall/syndicate,
/area/shuttle/syndicate/medical)
"aJ" = (
/turf/closed/wall/r_wall/syndicate,
/area/shuttle/syndicate/medical)
"aK" = (
/turf/closed/wall/r_wall/syndicate/nodiagonal,
/area/shuttle/syndicate/medical)
"aN" = (
/obj/machinery/status_display/evac/directional/south,
/obj/effect/turf_decal/siding/thinplating_new/dark{
	dir = 8
	},
/obj/effect/turf_decal/stripes/red/line{
	dir = 8
	},
/turf/open/floor/iron/dark/textured_corner{
	dir = 4
	},
/area/shuttle/syndicate/eva)
"aO" = (
/obj/item/grenade/syndieminibomb{
	pixel_x = 4;
	pixel_y = 2
	},
/obj/item/grenade/syndieminibomb{
	pixel_x = -1
	},
/obj/item/grenade/c4{
	pixel_x = -6
	},
/obj/item/grenade/c4{
	pixel_x = -6
	},
/obj/item/grenade/c4{
	pixel_x = -6
	},
/obj/item/grenade/c4{
	pixel_x = -6
	},
/obj/item/grenade/c4{
	pixel_x = -6
	},
/obj/structure/table/reinforced/plastitaniumglass,
/turf/open/floor/iron/dark,
/area/shuttle/syndicate/airlock)
"aQ" = (
/obj/structure/closet/syndicate/personal,
/obj/effect/turf_decal/bot_red,
/turf/open/floor/mineral/plastitanium,
/area/shuttle/syndicate/airlock)
"aS" = (
/obj/structure/tank_dispenser/oxygen,
/turf/open/floor/iron/dark,
/area/shuttle/syndicate/eva)
"aU" = (
/obj/machinery/light/directional/east,
/obj/structure/rack,
/obj/item/crowbar/red,
/turf/open/floor/iron/dark,
/area/shuttle/syndicate/eva)
"aV" = (
/obj/effect/spawner/structure/window/reinforced/plasma/plastitanium,
/turf/open/floor/plating,
/area/shuttle/syndicate/hallway)
"aX" = (
/obj/machinery/light/directional/west,
/obj/item/sbeacondrop/bomb{
	pixel_y = 5
	},
/obj/item/sbeacondrop/bomb,
/obj/structure/table/reinforced/plastitaniumglass,
/turf/open/floor/iron/dark,
/area/shuttle/syndicate/airlock)
"aY" = (
/obj/machinery/door/poddoor{
	id = "smindicate";
	name = "outer blast door"
	},
/obj/docking_port/mobile/infiltrator,
/obj/structure/fans/tiny,
/obj/machinery/button/door/directional/north{
	id = "smindicate";
	name = "external door control";
	req_access_txt = "150"
	},
/obj/effect/turf_decal/siding/thinplating_new/dark{
	dir = 8
	},
/turf/open/floor/mineral/plastitanium,
/area/shuttle/syndicate/airlock)
"aZ" = (
/turf/open/floor/iron/dark,
/area/shuttle/syndicate/eva)
"bc" = (
/turf/open/floor/iron/dark,
/area/shuttle/syndicate/airlock)
"bd" = (
/obj/structure/chair/comfy/shuttle/tactical{
	dir = 8
	},
/obj/effect/turf_decal/bot_red,
/obj/structure/sign/warning/vacuum/external{
	pixel_x = 32
	},
/turf/open/floor/mineral/plastitanium,
/area/shuttle/syndicate/airlock)
"be" = (
/obj/machinery/suit_storage_unit/syndicate,
/obj/effect/turf_decal/bot_red,
/turf/open/floor/mineral/plastitanium,
/area/shuttle/syndicate/eva)
"bg" = (
/obj/effect/spawner/structure/window/reinforced/plasma/plastitanium,
/turf/open/floor/plating,
/area/shuttle/syndicate/eva)
"bh" = (
/obj/effect/spawner/structure/window/reinforced/plasma/plastitanium,
/turf/open/floor/plating,
/area/shuttle/syndicate/airlock)
"bi" = (
/obj/structure/overfloor_catwalk/iron_dark,
/turf/open/floor/plating,
/area/shuttle/syndicate/engineering)
"bj" = (
/turf/closed/wall/r_wall/syndicate/nodiagonal,
/area/shuttle/syndicate/engineering)
"bk" = (
/obj/structure/sign/poster/contraband/random/directional/west,
/obj/structure/chair/comfy/shuttle/tactical{
	dir = 4
	},
/turf/open/floor/iron/dark,
/area/shuttle/syndicate/hallway)
"bm" = (
/obj/effect/turf_decal/tile/yellow{
	dir = 1
	},
/turf/open/floor/iron/dark/textured,
/area/shuttle/syndicate/engineering)
"bn" = (
/turf/closed/wall/r_wall/syndicate,
/area/shuttle/syndicate/engineering)
"bo" = (
/obj/effect/turf_decal/stripes{
	dir = 8
	},
/turf/open/floor/iron/dark,
/area/shuttle/syndicate/hallway)
"bq" = (
/obj/structure/table/reinforced,
/obj/item/reagent_containers/glass/beaker/large{
	pixel_x = 5;
	pixel_y = 5
	},
/obj/item/reagent_containers/glass/beaker,
/obj/item/reagent_containers/dropper{
	pixel_x = -4;
	pixel_y = -8
	},
/obj/effect/turf_decal/tile/yellow{
	dir = 1
	},
/turf/open/floor/iron,
/area/shuttle/syndicate/medical)
"br" = (
/turf/open/floor/iron,
/area/shuttle/syndicate/medical)
"bs" = (
/obj/machinery/light/directional/north,
/obj/structure/bed/roller,
/obj/machinery/iv_drip,
/obj/effect/turf_decal/siding/thinplating_new{
	dir = 4
	},
/obj/structure/railing{
	dir = 4
	},
/obj/item/reagent_containers/blood/o_minus,
/obj/item/reagent_containers/blood/o_minus,
/obj/item/reagent_containers/blood/o_minus,
/obj/item/reagent_containers/blood/o_minus,
/turf/open/floor/iron/dark/textured_large,
/area/shuttle/syndicate/medical)
"bt" = (
/obj/item/reagent_containers/syringe/epinephrine{
	pixel_x = 3;
	pixel_y = -2
	},
/obj/item/reagent_containers/syringe/epinephrine{
	pixel_x = 4;
	pixel_y = 1
	},
/obj/item/reagent_containers/syringe/epinephrine{
	pixel_y = 5
	},
/obj/item/reagent_containers/syringe/epinephrine{
	pixel_x = 2;
	pixel_y = 8
	},
/obj/structure/table/reinforced,
/obj/machinery/status_display/ai/directional/north,
/obj/effect/turf_decal/tile/blue{
	dir = 1
	},
/turf/open/floor/iron,
/area/shuttle/syndicate/medical)
"bu" = (
/obj/structure/table/reinforced,
/obj/item/stack/gauze,
/obj/item/stack/medical/bruise_pack,
/obj/item/stack/medical/ointment,
/obj/effect/turf_decal/tile/blue{
	dir = 4
	},
/turf/open/floor/iron,
/area/shuttle/syndicate/medical)
"bv" = (
/obj/effect/spawner/structure/window/reinforced/plasma/plastitanium,
/turf/open/floor/plating,
/area/shuttle/syndicate/medical)
"bw" = (
/obj/effect/spawner/structure/window/reinforced/plasma/plastitanium,
/turf/open/floor/plating,
/area/shuttle/syndicate/engineering)
"bx" = (
/obj/item/assembly/prox_sensor{
	pixel_x = -8;
	pixel_y = 4
	},
/obj/item/assembly/prox_sensor{
	pixel_x = -8;
	pixel_y = 4
	},
/obj/item/stack/cable_coil,
/obj/item/stack/cable_coil,
/obj/item/assembly/voice{
	pixel_y = 3
	},
/obj/structure/table/reinforced/plastitaniumglass,
/turf/open/floor/iron/dark/side,
/area/shuttle/syndicate/engineering)
"by" = (
/obj/machinery/status_display/evac/directional/north,
/obj/item/assembly/signaler{
	pixel_x = 8
	},
/obj/item/assembly/infra,
/obj/structure/table/reinforced/plastitaniumglass,
/turf/open/floor/iron/dark/side,
/area/shuttle/syndicate/engineering)
"bz" = (
/obj/machinery/light/directional/north,
/obj/item/weldingtool/largetank{
	pixel_y = 3
	},
/obj/item/multitool,
/obj/item/wrench,
/obj/item/crowbar/red,
/obj/structure/table/reinforced/plastitaniumglass,
/turf/open/floor/iron/dark/side,
/area/shuttle/syndicate/engineering)
"bA" = (
/obj/machinery/portable_atmospherics/canister/oxygen,
/obj/effect/turf_decal/stripes/line{
	dir = 10
	},
/obj/structure/railing{
	dir = 8
	},
/obj/structure/sign/poster/contraband/random/directional/north,
/turf/open/floor/plating,
/area/shuttle/syndicate/engineering)
"bB" = (
/obj/machinery/portable_atmospherics/canister/oxygen,
/obj/effect/turf_decal/stripes/line,
/turf/open/floor/plating,
/area/shuttle/syndicate/engineering)
"bC" = (
/obj/machinery/sleeper/syndie{
	dir = 4
	},
/obj/effect/turf_decal/siding/thinplating_new,
/obj/structure/railing,
/turf/open/floor/iron/dark/textured_large,
/area/shuttle/syndicate/medical)
"bD" = (
/obj/structure/chair/comfy/shuttle/tactical{
	dir = 8
	},
/turf/open/floor/iron/dark,
/area/shuttle/syndicate/hallway)
"bJ" = (
/obj/machinery/nuclearbomb/syndicate{
	anchored = 1
	},
/obj/machinery/door/window/survival_pod{
	dir = 1
	},
/obj/effect/turf_decal/siding/red,
/obj/structure/railing,
/turf/open/floor/circuit/red,
/area/shuttle/syndicate/hallway)
"bK" = (
/obj/effect/turf_decal/siding/thinplating_new/dark/corner,
/obj/machinery/door/airlock/hatch{
	req_access_txt = "150";
	name = "Infirmary"
	},
/obj/effect/turf_decal/siding/thinplating_new{
	dir = 8
	},
/turf/open/floor/mineral/plastitanium/red,
/area/shuttle/syndicate/medical)
"bM" = (
/obj/effect/turf_decal/siding/thinplating_new/dark{
	dir = 4
	},
/obj/effect/turf_decal/siding/thinplating_new/dark/corner{
	dir = 8
	},
/obj/machinery/door/airlock/hatch{
	req_access_txt = "150";
	name = "Engine Bay"
	},
/turf/open/floor/mineral/plastitanium/red,
/area/shuttle/syndicate/engineering)
"bO" = (
/obj/machinery/porta_turret/syndicate/shuttle{
	dir = 5
	},
/turf/closed/wall/r_wall/syndicate,
/area/shuttle/syndicate/airlock)
"bR" = (
/obj/structure/table/reinforced,
/obj/item/reagent_containers/glass/bottle/epinephrine{
	pixel_x = -3;
	pixel_y = 8
	},
/obj/item/reagent_containers/glass/bottle/dylovene,
/obj/item/reagent_containers/glass/bottle/dylovene,
/obj/item/reagent_containers/glass/bottle/epinephrine{
	pixel_x = 6
	},
/obj/effect/turf_decal/tile/yellow/half{
	dir = 8
	},
/turf/open/floor/iron,
/area/shuttle/syndicate/medical)
"bV" = (
/obj/effect/turf_decal/stripes{
	dir = 4
	},
/turf/open/floor/iron/dark,
/area/shuttle/syndicate/hallway)
"bW" = (
/obj/effect/turf_decal/tile/yellow{
	dir = 4
	},
/turf/open/floor/iron/dark/textured,
/area/shuttle/syndicate/engineering)
"bX" = (
/obj/machinery/suit_storage_unit/syndicate,
/obj/effect/turf_decal/bot_red,
/obj/structure/sign/poster/contraband/random/directional/west,
/turf/open/floor/mineral/plastitanium,
/area/shuttle/syndicate/eva)
"bY" = (
/obj/structure/closet,
/obj/effect/turf_decal/tile/yellow{
	dir = 8
	},
/obj/item/storage/medkit/regular,
/obj/item/storage/medkit/regular,
/obj/item/storage/medkit/fire,
/obj/item/storage/medkit/o2,
/obj/item/storage/medkit/brute,
/obj/item/storage/medkit/brute,
/turf/open/floor/iron,
/area/shuttle/syndicate/medical)
"ce" = (
/obj/machinery/cell_charger,
/obj/item/stock_parts/cell/high{
	pixel_x = -3;
	pixel_y = 3
	},
/obj/item/stock_parts/cell/high,
/obj/effect/turf_decal/tile/yellow{
	dir = 8
	},
/obj/structure/extinguisher_cabinet/directional/west,
/obj/structure/table/reinforced/plastitaniumglass,
/turf/open/floor/iron/dark/textured,
/area/shuttle/syndicate/engineering)
"cf" = (
/obj/item/storage/toolbox/syndicate,
/obj/item/screwdriver{
	pixel_y = 9
	},
/obj/structure/table/reinforced/plastitaniumglass,
/turf/open/floor/iron/dark,
/area/shuttle/syndicate/engineering)
"cg" = (
/obj/structure/reagent_dispensers/fueltank,
/turf/open/floor/iron/dark,
/area/shuttle/syndicate/engineering)
"ch" = (
/turf/open/floor/iron/dark,
/area/shuttle/syndicate/engineering)
"ci" = (
/obj/effect/turf_decal/tile/yellow,
/turf/open/floor/iron/dark/textured,
/area/shuttle/syndicate/engineering)
"cl" = (
/obj/effect/turf_decal/caution/stand_clear{
	dir = 1
	},
/turf/open/floor/iron/dark,
/area/shuttle/syndicate/hallway)
"cp" = (
/obj/structure/table/optable,
/turf/open/floor/iron/white,
/area/shuttle/syndicate/medical)
"cr" = (
/obj/structure/shuttle/engine/heater,
/obj/effect/turf_decal/stripes/line,
/obj/structure/window/reinforced/survival_pod{
	dir = 1
	},
/turf/open/floor/plating/airless,
/area/shuttle/syndicate/hallway)
"cs" = (
/obj/machinery/recharge_station,
/turf/open/floor/circuit/red,
/area/shuttle/syndicate/engineering)
"ct" = (
/obj/machinery/telecomms/allinone{
	intercept = 1
	},
/turf/open/floor/circuit/red,
/area/shuttle/syndicate/engineering)
"cu" = (
/obj/structure/shuttle/engine/heater,
/obj/effect/turf_decal/stripes/line,
/obj/structure/window/reinforced/survival_pod{
	dir = 1
	},
/turf/open/floor/plating/airless,
/area/shuttle/syndicate/medical)
"cv" = (
/obj/structure/shuttle/engine/propulsion/left,
/obj/effect/turf_decal/stripes/line,
/turf/open/floor/plating/airless,
/area/shuttle/syndicate/hallway)
"cw" = (
/obj/structure/shuttle/engine/propulsion,
/obj/effect/turf_decal/stripes/line,
/turf/open/floor/plating/airless,
/area/shuttle/syndicate/hallway)
"cx" = (
/obj/structure/shuttle/engine/propulsion/right,
/obj/effect/turf_decal/stripes/line,
/turf/open/floor/plating/airless,
/area/shuttle/syndicate/hallway)
"cy" = (
/obj/structure/shuttle/engine/heater,
/obj/effect/turf_decal/stripes/line,
/obj/structure/window/reinforced/survival_pod{
	dir = 1
	},
/turf/open/floor/plating/airless,
/area/shuttle/syndicate/engineering)
"cz" = (
/obj/structure/shuttle/engine/propulsion/left,
/obj/effect/turf_decal/stripes/line,
/turf/open/floor/plating/airless,
/area/shuttle/syndicate/medical)
"cA" = (
/obj/structure/shuttle/engine/propulsion,
/obj/effect/turf_decal/stripes/line,
/turf/open/floor/plating/airless,
/area/shuttle/syndicate/medical)
"cB" = (
/obj/structure/shuttle/engine/propulsion/right,
/obj/effect/turf_decal/stripes/line,
/turf/open/floor/plating/airless,
/area/shuttle/syndicate/medical)
"cE" = (
/obj/structure/shuttle/engine/propulsion/left,
/obj/effect/turf_decal/stripes/line,
/turf/open/floor/plating/airless,
/area/shuttle/syndicate/engineering)
"cF" = (
/obj/structure/shuttle/engine/propulsion,
/obj/effect/turf_decal/stripes/line,
/turf/open/floor/plating/airless,
/area/shuttle/syndicate/engineering)
"cG" = (
/obj/structure/shuttle/engine/propulsion/right,
/obj/effect/turf_decal/stripes/line,
/turf/open/floor/plating/airless,
/area/shuttle/syndicate/engineering)
"df" = (
/obj/machinery/newscaster/directional/south,
/turf/open/floor/iron/dark,
/area/shuttle/syndicate/bridge)
"dp" = (
/obj/machinery/porta_turret/syndicate/shuttle{
	dir = 10
	},
/turf/closed/wall/r_wall/syndicate,
/area/shuttle/syndicate/engineering)
"dz" = (
/obj/structure/overfloor_catwalk/iron_dark,
/turf/open/floor/plating,
/area/shuttle/syndicate/medical)
"el" = (
/obj/machinery/light/directional/east,
/turf/open/floor/iron/dark,
/area/shuttle/syndicate/hallway)
"fk" = (
/obj/machinery/light/directional/east,
/obj/effect/turf_decal/siding/red,
/obj/structure/window/reinforced/survival_pod{
	dir = 1
	},
/obj/effect/turf_decal/stripes/red/line{
	dir = 1
	},
/turf/open/floor/iron/dark,
/area/shuttle/syndicate/engineering)
"gt" = (
/obj/item/storage/box/handcuffs{
	pixel_x = 3;
	pixel_y = 3
	},
/obj/item/storage/box/zipties,
/obj/machinery/computer/security/telescreen/entertainment/directional/west,
/obj/structure/table/reinforced/plastitaniumglass,
/turf/open/floor/iron/dark,
/area/shuttle/syndicate/airlock)
"hT" = (
/obj/machinery/light/directional/east,
/obj/effect/turf_decal/syndicateemblem/bottom/right,
/turf/open/floor/mineral/plastitanium/red,
/area/shuttle/syndicate/hallway)
"iE" = (
/obj/structure/closet/syndicate/nuclear,
/obj/structure/railing,
/obj/effect/turf_decal/bot_red,
/turf/open/floor/mineral/plastitanium,
/area/shuttle/syndicate/airlock)
"jf" = (
/obj/effect/turf_decal/siding/red,
/obj/structure/window/reinforced/survival_pod{
	dir = 1
	},
/obj/effect/turf_decal/stripes/red/line{
	dir = 1
	},
/turf/open/floor/iron/dark,
/area/shuttle/syndicate/engineering)
"lm" = (
/obj/machinery/door/airlock/hatch{
	req_access_txt = "150";
	name = "Cockpit"
	},
/obj/effect/turf_decal/stripes/red/line{
	dir = 1
	},
/turf/open/floor/iron/dark,
/area/shuttle/syndicate/bridge)
"lo" = (
/obj/effect/turf_decal/siding/thinplating_new/dark{
	dir = 8
	},
/obj/effect/turf_decal/siding/thinplating_new/dark/corner{
	dir = 4
	},
/obj/machinery/door/airlock/hatch{
	req_access_txt = "150";
	name = "E.V.A. Prep"
	},
/turf/open/floor/mineral/plastitanium/red,
/area/shuttle/syndicate/eva)
"lJ" = (
/obj/effect/turf_decal/siding/thinplating_new,
/obj/structure/overfloor_catwalk/iron_dark,
/turf/open/floor/plating,
/area/shuttle/syndicate/medical)
"mj" = (
/obj/effect/turf_decal/tile/red/half{
	dir = 4
	},
/turf/open/floor/iron/dark,
/area/shuttle/syndicate/airlock)
"mW" = (
/obj/effect/turf_decal/loading_area{
	dir = 1
	},
/turf/open/floor/iron/dark,
/area/shuttle/syndicate/hallway)
"mZ" = (
/obj/effect/turf_decal/tile/blue{
	dir = 1
	},
/turf/open/floor/iron,
/area/shuttle/syndicate/medical)
"nq" = (
/obj/machinery/light/directional/west,
/turf/open/floor/iron/dark,
/area/shuttle/syndicate/hallway)
"nN" = (
/obj/structure/chair/comfy/shuttle/tactical{
	dir = 8
	},
/obj/effect/turf_decal/bot_red,
/turf/open/floor/mineral/plastitanium,
/area/shuttle/syndicate/airlock)
"nZ" = (
/obj/item/cautery,
/obj/item/scalpel,
/obj/structure/table/reinforced,
/obj/effect/turf_decal/tile/blue{
	dir = 8
	},
/turf/open/floor/iron/white,
/area/shuttle/syndicate/medical)
"pd" = (
/obj/machinery/porta_turret/syndicate/shuttle{
	dir = 5
	},
/turf/closed/wall/r_wall/syndicate,
/area/shuttle/syndicate/bridge)
"pQ" = (
/obj/item/retractor,
/obj/item/hemostat,
/obj/structure/table/reinforced,
/obj/effect/turf_decal/tile/blue,
/turf/open/floor/iron/white,
/area/shuttle/syndicate/medical)
"st" = (
/obj/effect/turf_decal/syndicateemblem/top/right,
/obj/machinery/newscaster/directional/east,
/turf/open/floor/mineral/plastitanium/red,
/area/shuttle/syndicate/hallway)
"sv" = (
/obj/structure/rack,
/obj/item/clothing/suit/space/syndicate,
/obj/item/clothing/head/helmet/space/syndicate,
/turf/open/floor/iron/dark,
/area/shuttle/syndicate/eva)
"tG" = (
/obj/structure/overfloor_catwalk/iron_dark,
/turf/open/floor/plating,
/area/shuttle/syndicate/bridge)
"tM" = (
/turf/open/floor/iron/dark/textured_corner{
	dir = 1
	},
/area/shuttle/syndicate/engineering)
"ug" = (
/obj/machinery/light/directional/west,
/obj/effect/turf_decal/syndicateemblem/bottom/left,
/turf/open/floor/mineral/plastitanium/red,
/area/shuttle/syndicate/hallway)
"uO" = (
/obj/effect/turf_decal/tile/blue,
/obj/machinery/bodyscanner{
	dir = 8
	},
/turf/open/floor/iron,
/area/shuttle/syndicate/medical)
"vl" = (
/obj/effect/turf_decal/tile/blue,
/obj/structure/sign/poster/contraband/random/directional/south,
/obj/machinery/bodyscanner_console{
	dir = 8
	},
/turf/open/floor/iron,
/area/shuttle/syndicate/medical)
"vv" = (
/obj/item/clothing/head/hos/syndicate,
/obj/item/stamp/syndicate{
	pixel_x = -7
	},
/obj/structure/table/reinforced/plastitaniumglass,
/turf/open/floor/iron/dark,
/area/shuttle/syndicate/bridge)
"vQ" = (
/obj/machinery/computer/security/telescreen/entertainment/directional/south,
/turf/open/floor/iron/dark,
/area/shuttle/syndicate/bridge)
"wK" = (
/obj/effect/turf_decal/tile/red/half{
	dir = 8
	},
/turf/open/floor/iron/dark,
/area/shuttle/syndicate/eva)
"ye" = (
/obj/effect/turf_decal/siding/thinplating_new/dark{
	dir = 8
	},
/obj/effect/turf_decal/stripes/red/line{
	dir = 8
	},
/turf/open/floor/iron/dark/textured_corner,
/area/shuttle/syndicate/eva)
"yf" = (
/obj/structure/chair/comfy/shuttle/tactical{
	dir = 4
	},
/turf/open/floor/iron/dark,
/area/shuttle/syndicate/airlock)
"zc" = (
/obj/machinery/sleeper/syndie{
	dir = 4
	},
/turf/open/floor/iron/dark/textured_large,
/area/shuttle/syndicate/medical)
"zd" = (
/obj/effect/turf_decal/siding/thinplating_new/dark,
/turf/open/floor/mineral/plastitanium/red,
/area/shuttle/syndicate/hallway)
"zj" = (
/obj/structure/table/reinforced,
/obj/machinery/light/directional/west,
/obj/item/bodypart/arm/left/robot{
	pixel_x = -4;
	pixel_y = 8
	},
/obj/item/bodypart/arm/right/robot{
	pixel_x = -10;
	pixel_y = 9
	},
/obj/item/surgicaldrill,
/obj/item/circular_saw,
/obj/effect/turf_decal/tile/blue{
	dir = 8
	},
/turf/open/floor/iron/white/side,
/area/shuttle/syndicate/medical)
"zL" = (
/obj/machinery/light/directional/west,
/obj/machinery/computer/med_data/syndie{
	dir = 4
	},
/obj/effect/turf_decal/tile/red{
	dir = 8
	},
/turf/open/floor/iron/dark,
/area/shuttle/syndicate/bridge)
"zR" = (
/obj/effect/turf_decal/syndicateemblem/top/left,
/obj/item/radio/intercom/directional/west,
/turf/open/floor/mineral/plastitanium/red,
/area/shuttle/syndicate/hallway)
"Az" = (
/obj/machinery/status_display/ai/directional/south,
/obj/effect/turf_decal/siding/thinplating_new/dark{
	dir = 4
	},
/turf/open/floor/iron/dark/textured_corner{
	dir = 1
	},
/area/shuttle/syndicate/airlock)
"AZ" = (
/obj/effect/turf_decal/tile/red{
	dir = 4
	},
/obj/structure/chair/comfy/shuttle/tactical{
	dir = 8
	},
/turf/open/floor/iron/dark,
/area/shuttle/syndicate/hallway)
"BH" = (
/obj/effect/turf_decal/siding/thinplating_new/dark{
	dir = 4
	},
/obj/structure/sign/poster/contraband/random/directional/north,
/turf/open/floor/iron/dark/textured_corner{
	dir = 8
	},
/area/shuttle/syndicate/airlock)
"CZ" = (
/obj/effect/turf_decal/tile/red{
	dir = 1
	},
/obj/structure/chair/comfy/shuttle/tactical{
	dir = 4
	},
/turf/open/floor/iron/dark,
/area/shuttle/syndicate/hallway)
"DP" = (
/obj/machinery/light/directional/east,
/obj/effect/turf_decal/tile/red,
/obj/machinery/computer/aifixer{
	dir = 8
	},
/turf/open/floor/iron/dark,
/area/shuttle/syndicate/bridge)
"Ed" = (
/obj/machinery/door/window/survival_pod{
	dir = 1;
	req_access_txt = "150";
	name = "Telecommunications Centre"
	},
/obj/effect/turf_decal/siding/red,
/obj/effect/turf_decal/stripes/red/line{
	dir = 1
	},
/turf/open/floor/iron/dark,
/area/shuttle/syndicate/engineering)
"Fe" = (
/obj/effect/turf_decal/syndicateemblem/bottom/middle,
/turf/open/floor/mineral/plastitanium/red,
/area/shuttle/syndicate/hallway)
"Fs" = (
/obj/machinery/computer/station_alert{
	dir = 8
	},
/obj/effect/turf_decal/tile/red/anticorner,
/obj/machinery/status_display/ai{
	pixel_x = 32
	},
/turf/open/floor/iron/dark,
/area/shuttle/syndicate/bridge)
"GW" = (
/obj/effect/turf_decal/syndicateemblem/middle/middle,
/turf/open/floor/mineral/plastitanium/red,
/area/shuttle/syndicate/hallway)
"Hl" = (
/obj/machinery/door/airlock/external/ruin{
	req_access_txt = "150";
	name = "External Airlock"
	},
/obj/effect/turf_decal/siding/thinplating_new/dark{
	dir = 4
	},
/obj/effect/turf_decal/siding/thinplating_new/dark/corner{
	dir = 1
	},
/turf/open/floor/mineral/plastitanium/red,
/area/shuttle/syndicate/airlock)
"In" = (
/obj/machinery/porta_turret/syndicate/shuttle{
	dir = 6
	},
/turf/closed/wall/r_wall/syndicate,
/area/shuttle/syndicate/hallway)
"Jo" = (
/turf/open/floor/iron/dark/textured_corner,
/area/shuttle/syndicate/engineering)
"JQ" = (
/obj/structure/mirror/directional/east,
/obj/effect/turf_decal/tile/blue,
/obj/structure/rack,
/obj/item/defibrillator/loaded,
/turf/open/floor/iron/white/side,
/area/shuttle/syndicate/medical)
"Km" = (
/obj/structure/chair/stool/directional/east,
/turf/open/floor/iron/dark,
/area/shuttle/syndicate/engineering)
"KB" = (
/obj/effect/turf_decal/tile/red/half{
	dir = 4
	},
/obj/structure/chair/office/tactical{
	dir = 8
	},
/turf/open/floor/iron/dark,
/area/shuttle/syndicate/airlock)
"KQ" = (
/turf/open/floor/iron/white/side,
/area/shuttle/syndicate/medical)
"Lh" = (
/obj/effect/turf_decal/siding/thinplating_new{
	dir = 6
	},
/obj/structure/railing{
	dir = 6
	},
/obj/machinery/vitals_monitor,
/turf/open/floor/iron/dark/textured_large,
/area/shuttle/syndicate/medical)
"MJ" = (
/obj/machinery/porta_turret/syndicate/shuttle{
	dir = 6
	},
/turf/closed/wall/r_wall/syndicate,
/area/shuttle/syndicate/medical)
"Nk" = (
/obj/structure/chair/comfy/shuttle/tactical{
	dir = 4
	},
/turf/open/floor/iron/dark,
/area/shuttle/syndicate/hallway)
"Nr" = (
/obj/machinery/computer/secure_data/laptop/syndie,
/obj/structure/table/reinforced/plastitaniumglass,
/turf/open/floor/iron/dark,
/area/shuttle/syndicate/airlock)
"NA" = (
/obj/effect/turf_decal/tile/red/half{
	dir = 8
	},
/turf/open/floor/iron/dark,
/area/shuttle/syndicate/airlock)
"NZ" = (
/obj/structure/sink{
	dir = 8;
	pixel_x = 11
	},
/turf/open/floor/iron,
/area/shuttle/syndicate/medical)
"Qb" = (
/obj/effect/turf_decal/syndicateemblem/middle/left,
/turf/open/floor/mineral/plastitanium/red,
/area/shuttle/syndicate/hallway)
"Qq" = (
/obj/effect/turf_decal/siding/thinplating_new/dark{
	dir = 8
	},
/obj/effect/turf_decal/stripes/red/line{
	dir = 8
	},
/turf/open/floor/iron/dark/textured_edge{
	dir = 8
	},
/area/shuttle/syndicate/eva)
"Qx" = (
/obj/effect/turf_decal/syndicateemblem/middle/right,
/turf/open/floor/mineral/plastitanium/red,
/area/shuttle/syndicate/hallway)
"QF" = (
/obj/effect/turf_decal/siding/thinplating_new/dark,
/obj/effect/turf_decal/caution{
	pixel_y = 2;
	dir = 1
	},
/turf/open/floor/mineral/plastitanium/red,
/area/shuttle/syndicate/hallway)
"Ro" = (
/obj/effect/turf_decal/tile/blue/full,
/turf/open/floor/iron,
/area/shuttle/syndicate/medical)
"RO" = (
/obj/effect/turf_decal/loading_area/red{
	dir = 4
	},
/turf/open/floor/mineral/plastitanium,
/area/shuttle/syndicate/airlock)
"Tu" = (
/obj/machinery/door/airlock/hatch{
	req_access_txt = "150";
	name = "Ready Room"
	},
/turf/open/floor/iron/dark,
/area/shuttle/syndicate/hallway)
"TD" = (
/obj/effect/turf_decal/tile/red/half{
	dir = 4
	},
/turf/open/floor/iron/dark,
/area/shuttle/syndicate/eva)
"UN" = (
/obj/effect/turf_decal/siding/thinplating_new/dark{
	dir = 1
	},
/turf/open/floor/mineral/plastitanium/red,
/area/shuttle/syndicate/hallway)
"UY" = (
/obj/effect/turf_decal/stripes/red/line,
/turf/open/floor/iron/dark,
/area/shuttle/syndicate/hallway)
"VW" = (
/obj/effect/turf_decal/syndicateemblem/top/middle,
/turf/open/floor/mineral/plastitanium/red,
/area/shuttle/syndicate/hallway)
"Xw" = (
/obj/structure/chair/comfy/shuttle/tactical{
	dir = 8
	},
/turf/open/floor/iron/dark,
/area/shuttle/syndicate/eva)
"YU" = (
/obj/machinery/computer/crew/syndie{
	dir = 4
	},
/obj/effect/turf_decal/tile/red/anticorner{
	dir = 8
	},
/obj/machinery/status_display/evac{
	pixel_x = -32
	},
/turf/open/floor/iron/dark,
/area/shuttle/syndicate/bridge)
"ZL" = (
/obj/effect/turf_decal/tile/blue,
/turf/open/floor/iron,
/area/shuttle/syndicate/medical)

(1,1,1) = {"
aa
aa
aa
aa
aa
aa
aa
aa
aa
aa
aa
aa
aa
aG
aJ
aJ
aJ
aJ
aJ
aJ
aJ
aJ
aJ
"}
(2,1,1) = {"
aa
aa
aa
aa
aa
aa
aa
aw
ax
ax
ax
ax
ax
aJ
zc
bC
bq
bR
bY
zj
nZ
cu
cz
"}
(3,1,1) = {"
aa
aa
aa
aa
aa
aa
aa
ax
be
be
be
bX
be
aJ
dz
lJ
ZL
br
Ro
KQ
cp
cu
cA
"}
(4,1,1) = {"
aa
aa
aa
aa
aa
aa
aa
ax
ye
Qq
Qq
Qq
aN
aJ
bs
Lh
br
mZ
br
JQ
pQ
cu
cB
"}
(5,1,1) = {"
ab
ac
ac
ac
ac
aa
aa
ax
aZ
wK
TD
wK
aZ
aJ
bt
br
Ro
br
uO
aK
aJ
aJ
MJ
"}
(6,1,1) = {"
ac
ag
zL
YU
ac
ad
aa
ax
aS
sv
aU
Xw
aZ
aJ
bu
NZ
br
br
vl
aJ
aa
aa
aa
"}
(7,1,1) = {"
ae
ah
ao
df
ac
af
af
ax
ax
ax
ax
bg
lo
aK
bv
aJ
bK
bv
aJ
aJ
af
af
aa
"}
(8,1,1) = {"
ae
ai
tG
ap
ac
CZ
bk
nq
Nk
Nk
aV
UY
UN
zR
Qb
ug
zd
bo
bo
aV
cr
cv
aa
"}
(9,1,1) = {"
ae
aj
aq
ap
lm
aD
ak
ak
ak
aD
Tu
UY
UN
VW
GW
Fe
QF
cl
mW
bJ
cr
cw
aa
"}
(10,1,1) = {"
ae
al
tG
ap
ac
AZ
bD
el
bD
bD
aV
UY
UN
st
Qx
hT
zd
bV
bV
aV
cr
cx
aa
"}
(11,1,1) = {"
ae
vv
ar
vQ
ac
af
af
aB
aB
aB
aB
bh
Hl
bj
bw
bn
bM
bw
bn
bn
af
af
aa
"}
(12,1,1) = {"
ac
am
DP
Fs
ac
In
aa
aB
gt
aO
aX
yf
bc
bn
bx
bm
ch
Km
ce
bn
aa
aa
aa
"}
(13,1,1) = {"
pd
ac
ac
ac
ac
aa
aa
aB
Nr
KB
NA
mj
bc
bn
by
ch
bi
bi
cf
bj
bn
bn
dp
"}
(14,1,1) = {"
aa
aa
aa
aa
aa
aa
aa
aB
BH
as
as
as
Az
bn
bz
ch
Jo
tM
cg
jf
cs
cy
cE
"}
(15,1,1) = {"
aa
aa
aa
aa
aa
aa
aa
aB
aQ
iE
RO
bd
nN
bn
bA
ch
bi
bi
ch
Ed
ct
cy
cF
"}
(16,1,1) = {"
aa
aa
aa
aa
aa
aa
aa
bO
aB
aB
aY
aB
aB
bn
bB
bW
ch
ch
ci
fk
cs
cy
cG
"}
(17,1,1) = {"
aa
aa
aa
aa
aa
aa
aa
aa
aa
aa
aa
aa
aa
aF
bn
bn
bn
bn
bn
bn
bn
bn
bn
"}
