//MAP CONVERTED BY dmm2tgm.py THIS HEADER COMMENT PREVENTS RECONVERSION, DO NOT REMOVE
"a" = (
/turf/closed/wall/mineral/titanium,
/area/shuttle/mining)
"b" = (
/turf/open/floor/mineral/titanium,
/area/shuttle/mining)
"e" = (
/obj/structure/closet/crate,
/obj/machinery/light/directional/east,
/turf/open/floor/mineral/titanium,
/area/shuttle/mining)
"f" = (
/obj/structure/shuttle/engine/heater,
/obj/structure/window/reinforced{
	dir = 4
	},
/obj/structure/window/reinforced,
/turf/open/floor/mineral/titanium,
/area/shuttle/mining)
"s" = (
/obj/structure/chair/comfy/shuttle{
	dir = 4
	},
/turf/open/floor/mineral/titanium,
/area/shuttle/mining)
"v" = (
/obj/machinery/computer/shuttle/mining{
	dir = 8
	},
/turf/open/floor/mineral/titanium,
/area/shuttle/mining)
"z" = (
/obj/structure/shuttle/engine/propulsion/burst/cargo{
	dir = 8
	},
/turf/open/space/basic,
/area/shuttle/mining)
"M" = (
/obj/effect/spawner/structure/window/reinforced/shuttle,
/turf/open/floor/plating,
/area/shuttle/mining)
"W" = (
/obj/machinery/door/airlock/titanium{
	name = "Mining Shuttle Airlock"
	},
/obj/docking_port/mobile{
	dwidth = 3;
	height = 5;
	id = "mining";
	name = "mining shuttle";
	port_direction = 2;
	width = 7
	},
/turf/open/floor/mineral/titanium,
/area/shuttle/mining)

(1,1,1) = {"
a
z
a
a
"}
(2,1,1) = {"
a
f
s
a
"}
(3,1,1) = {"
M
s
b
W
"}
(4,1,1) = {"
a
v
e
a
"}
(5,1,1) = {"
a
M
a
a
"}
